HMGA1	---GPRQPPKRPGNKRP-RL
HMGA2	---GPRQQQERPGNKKP-RW
ASH1L	RPFGPKQMRLKKKEVKR-RC
SETBP1	--VGPKQPLSKKKDVKR-RQ
SRCAP	--VGPPKNRERRKDPKK-RN
NFIA	SRRPYRDFVLVTCLSNDQKI
NFIX	SRRPFRDFVLITCLSNDQKI
NFIB	SRRQYRDFVLVTCLSNDQKI
NFIC	SRRPCRDFVLITGLSNDQKI
SMAD1	DAKAEEEKALCPNTIPSLRS
SMAD9	DSKADEERALCPKTIPSLRS
SMAD5	DAKAEEEKALSPKTIPSLRS
SMAD3	KSKQDEEKAITQKTIPSLRS
SMAD4	ESKEDSITAITNKTIQTLRA
IRF1	EMQIINEEMIQIAGWDNKCS
IRF2	EETKLNEKKIQIAGWDEKPN
IRF4	IDKVENEKSIRIGDYNEEAA
IRF8	IEMIENEKSMRIGDYNEVSA
IRF9	IDQIENEEMIRIGDYWDEAS
IRF5	VAQQVNEKKLCITGPSDGTA
IRF6	VALILHDSKRQITSPQEETA
IRF3	VSQAVNSRTRRILDAQQEGA
IRF7	LGCQLDARTCRVADLSEARA
NFYA	LYYKRQRAKLAEEKYLESRA
CAMTA1	NGSMILYNRKKVKYRKDGYC
CAMTA2	HMKLKVQGVECLYGCYVHSS
ETV3	QQKEEFRHVAEYKDERQNHT
ETV3L	QQKEEFRHVAEYKDERQNHT
ERF	QRKEEYQGVADYKDEVQNHT
FEV	QADRANAGCAGHTDEENDSV
FLI1	QSDSANASCTTNTDEENDTV
ETV2	QHDGARSSCRNSCDEEGRRS
ETS1	QTDKSCQSFSDGSDEKKDHT
ETS2	QSDKSCQSFSDGADEKKDHT
GABPA	QTDKDARDCSDENQLQTDCV
ETV1	QDDPSNSHFARGIEEIAEQV
ETV5	QDDPANAHFARGIEEIAEQV
ETV4	QDDPTNAHFARGIEEIAEQV
ELK3	TLDQKHEHLCDGLK------
ELK4	TQKPQNKHMCDGLQEINVKV
ELK1	TREQGNGHISDGVDELNDRV
EHF	HLNPKNPGLKSELKAKSKEV
ELF3	HIHPLNEGLKHELRAQNKEV
ELF5	HLSPENCGIEEQVKAQRKEV
ELF2	YQDKTCPRYKEKVDAKDQAV
ELF4	YQDRTCPKYKEKVDAKDQAV
ELF1	YQDKTCPKYKEKVDAKDQAV
SPDEF	HLKPSYGRFREKEDQIAKRP
ETV7	LLDTYEP-YKDAVDGNNKKE
SPI1	RRSGDMKDSWDKSHAIKKKV
SPIB	RTRGDMRECWGASHLQRKRV
SPIC	RYNPEMASCQTKVNKKTRTI
EBF2	-VMCRCCEKSNEVDFCTSVG
EBF3	EIMCRCCDKSNEVDFCNSVG
EBF1	EIMCRCCDKSNEVDFCNSVG
EBF4	EIMCRCCDRSNEVDFCNSVG
GCM1	WWSYHWMSCCRHTFGRFFHT
GCM2	QWGYFWMGCCRHTFGNFFHS
MTF2	AWGHNWHKSHYMKKGLRVNA
PHF1	KWGHNWHKRCYIKRGLRMTL
BPTF	QREKSWHKQLAPDNYYIKMQ
NFYB	NGSTAQHDYMIETECHKRIS
DR1	IITLVHINEARKALWLQQAS
GTF2B	CPILDWTDLNMRAAACEGIR
NFE4	CLLNKLLASHVTKHLSNPLD
NR0B1	EGWWSDPVSLEHERASQACI
FLYWCH1	LEVGVGRHKGTCTGVMHCGV
POU2AF1	TQAPPRKATLGWPTAPPYAY
SKOR1	DILYANAETDRPCPPDDNEY
PURA	EYDFHFVDRDKPIVWAGHEQ
NRF1	VVVHTYDAARQVSIESAEVP
CARF	QAYESPTIKPFCLSHKTQSK
CEBPZ	VVFVLIKPNDMLQPFFYYKA
CPEB1	APTSKRATLYVVFRRLSRHA
LTF	GVRIGWGSYKHCGNNSRYRN
NFYC	RKKREAQQIQVIVGQGQTIV
DNTTIP1	NNEEAGKLGSIYDHQHRALD
AHR	---PRDRTEDRSLPLSRLVS
AHRR	KSNPRDRAEDHSLPLSRLVS
EPAS1	SRDACSKEVYEHEPASRLIS
HIF1A	SRDASSKEVYEHQPASRLIS
HIF3A	SRDASSQEVYQHTPASRLIS
SIM1	SKNATEKSEYEKLPASRLTS
SIM2	SKNATEKGEYEKLPASRLTS
NPAS3	SRDASGKFEYEKLPASRLIS
NPAS1	SRNASGKLEFEKLPASRLVT
NPAS4	TKGAADQAERNELPLHSLCI
NCOA2	KRNTREQKYEEELFCAKEVK
NCOA3	--SGREQKYEEELSCAKEVR
NCOA1	ASSTREQKYEEELSCKKKVD
BHLHE40	HRLIKDRECAQDLPAVELLK
BHLHE41	HRLIKDRECAQDLPAVELLK
HEY2	RGIIRDRNSSERLPAEQMVD
HEYL	RGIIRDRSSSERLPAEQMVD
HEY1	RGIIRDRNSSERLPAEQMVD
HELT	HKVIRDRRCNEKTPAEEMVQ
HES1	KPIMRARESSQTLLADEMVK
HES4	KPVMRARESAQTLLADEMVR
HES2	KPLLRARQSSQGLLADEMVR
HES7	KPLVRDRRSEELLLAEEFVG
HES6	KPLVKARESQELLAAEELVR
HES5	KPVVMDRSSEQLLEADEMVS
HES3	---MKARVSEQSLEADELVK
SOHLH2	HSSKLERYCEQTLPASEAVD
CCDC169-SOHLH2	HSSKLERYCEQTLPASEAVD
SOHLH1	NVISEKRLSERALPASEMVQ
CLOCK	RNKSKDQVLKESMPSTQKID
NPAS2	RNKSKDQVLKESMPTTEKIG
SREBF1	HNAIRSSDKIEDLVSARKID
SREBF2	HNIIRSSDKIEDLMSGRKID
ARNT	HSEIRNKAYTEDMPLTRMVS
ARNT2	HSEIRNKQYTEDMPLTRMVS
ARNTL	HSQIRDKSFDESLPLTRMVQ
ARNTL2	HSQTRDKNLEEAMPLTRMVQ
MITF	HNLIRFNDRKETLPGTKAVD
TFE3	HNLIRFNDRKETLPGTKAVD
TFEC	HNLIRYNYRKETLPGTKAVE
TFEB	HNLIRFNDRKEMLPGTKAVD
ASCL1	RNERNKLLGATEHPVERSVE
ASCL2	RNERNKLLGQAQHPVERSVE
ASCL4	RNERQRCEGARDHPVERAID
ASCL5	RNERQKCEGARGHPVERAIR
ASCL3	RNERQKCEGAQHHPVERAIK
ATOH1	ANARRHGHADQNVPYEQMQI
ATOH7	ANARRQGTADRRVPYEQMLS
NEUROD1	ANARNHGAADNKVPIERLKN
NEUROD2	ANARNHDAADNKVPIERLKN
NEUROD6	ANARNHGDADNKVPIERLKN
NEUROD4	ANARTHGDADNRVPIERLRN
NEUROG2	ANNRNHNAADAEVPIERFHN
NEUROG3	ANDRNHNSADAGVPIERFHN
NEUROG1	ANDRNHNAADASVPIERFYN
BHLHA15	SNERQHKNAQAEVPIETLKN
BHLHE22	INARRHDDADEAVPIALLKN
BHLHE23	INARRHDDADGAVPIALLKN
OLIG2	INSRKHDIADGEVPIALLRN
OLIG3	INGRKHDLADGEVPIALLRN
OLIG1	INSRKQDLADAEVLIALLRN
FERD3L	ANIRKFNEADQRKPIERLIV
PTF1A	ANVRRQSDAEGSHPVDRLIG
BHLHA9	ANVRKLDEANARARIARRIH
HAND2	ANRKRQSSAAEECPIKRLTS
HAND1	GPKKRESSAAEECPIKRLTS
TWIST1	ANVRQQSEAAAKIPIQKLAR
TWIST2	ANVRQQSEAAAKIPIQKLAR
SCX	ANARDNSTATATLPIERLSS
TCF15	ANARDQSTATATLPIERLSS
LYL1	TNSRWQNGAAEKLPNERLMK
TAL1	TNSRWQNGAAEKLPNERLMK
TAL2	TNTRWQNSAAKKLPNERLMR
NHLH1	HATRIEALAAEKLPIERLIC
NHLH2	HATRIEALAAEKLPIERLIC
MSC	ANARARVKASRTSPLDRLSS
TCF21	ANARARVKASRTTPLDRLSS
TCF23	NAARSRTQALAAAPLDVLAS
TCF24	NAARSQTHALERTPLDLLTT
ATOH8	ANARTHTAAEAKQPLARICN
FIGLA	ANAKEKNRGARALPVDKGTE
MESP1	ASERLRTRAHERFPIERLIR
MESP2	ASERLRTRAHERFPIERLIR
MSGN1	ASERLRTDAHTNYPIQKYIK
MYF5	ATMRRKKQAETRCTVERNIR
MYOD1	ATMRRSKEAETRCSVERNIR
MYF6	ATLRRKKEAEARRVVERSIS
MYOG	ATLRRKKEAEARSLVERSIQ
TCF12	NNARLRDEAKERMQLLHQVA
TCF4	NNARLRDEAKERMQLLHQVA
TCF3	NNARLRDEAKERMQLLHQVS
MYC	HNVLQNERSFADQPVVKKTA
MYCN	HNILQNDSSLTDHPVVKKTE
MYCL	HNFLKNDSRLADQPVVSKLE
MAX	HNALKDHDSHSDSP------
MXI1	HNELNAHLCERVLPLGNKKA
MXD1	HNEMNAHLCEKGLPLSTKKL
MXD4	HNELHAKLYEQQLPLSKRKV
MXD3	HNELRAQRCERQQPLSRRRM
MNT	HNKLNAHECETRNPLSRTLR
TFAP4	ANSNRQSAGQSTLPAAQQAE
USF3	HNAVHKKAGNRELPNMDQFK
USF1	HNEVRDKNWVQKIPGGSKCD
USF2	HNEVRDKNWVQKIPGGSKCD
MLXIPL	HISAKFNLGDTGLSATQKAE
MLXIP	HISAKFNMCDMSLSAIQKVE
MLX	HTQAKDARGDDTIPAIQKID
TCFL5	HNRMDRRICDELLPATQWTA
MGA	HTANRGEDLEKITGSLTRFS
SOX2	MRGQRKAQNPKSEAEKSETR
SOX1	MRGQRKAQNPKSEAEKSEAR
SOX14	MRGQRKAQNPKSEAEKSEAR
SOX21	MRAQRKAQNPKSEAEKTESR
SOX3	MRGQRKALNPKSEADKTDAR
SOX15	MSAQRQAQNPKSEAQKDEDR
SRY	IRDQRKALNPRSEYQKTEAW
SOX8	MQAARKADYPHAEKLRSESR
SOX9	MQAARKADYPHAEKLRNESR
SOX10	MQAARKADYPHAEKLRNESR
SOX17	MKDEKRAQNPDAEKSKTLAR
SOX18	MKDEKRAQNPDAVKAKNAAR
SOX7	MKDEKRAVNPDAEKSKTLSR
SOX11	MKIERKMESPDAEKRKKDSI
SOX4	MQIERKMESPDAEKRKKDSI
SOX12	MQHERKMDWPDAERRQQDSI
SOX13	MKDERKLQFPDSSSRKTNQQ
SOX5	MKDERKLQFPDSNSRKTNLQ
SOX6	MKDERKLQFPDSNSRKSNQQ
SOX30	MRIHPAAKNPAAELENSEEK
BBX	LKRHSLRQHPRRGDWADPKQ
CIC	MKRHALHQHPNRTEWYGPKQ
HBP1	MKKYVETQYPGRADRKKNER
LEF1	MKEMANVACTLAARRHSREA
TCF7L2	MKEMAKVACTLAARRHSREA
TCF7	MKEMAKIACTLAARRHSREA
TCF7L1	MKEMAKVACTLAARKHSREA
HMG20A	VNEREQRARPEPENESPPEQ
HMG20B	VNEREQRTHPDPEAESQPTQ
RFX2	ELPRSLNHLRHHKASGIRSM
RFX3	ELPRTLNHLRHHKASGIRSM
RFX1	ELPRTLCHLLHQKASGIRSM
RFX4	EIPRALMHLDFNDASGIRQP
RFX6	ELPRILAHLDFEKATGIRQP
RFX5	TLPKSVDARKYLAANGIREP
RFX7	PLPKEVDEKSYLGADGMKNP
RUNX2	AVPDTVTVAGNYSSAMQVAN
RUNX3	AVPDTVTVAGNYSSAMQVAN
RUNX1	AVPDTLTVAGNYSTAMQVAN
RFX8	-----MEIVETNTATGE---
LCORL	DHEMMVSGKQIHSLKVKTTK
LCOR	NSELVVSGKQIHSLKVKTNK
TP63	CQIKIKMTPPQFTVNFMQGN
TP73	CQIKIKSTPPQFTINFMQGN
TP53	CQLKLWDSTPECTINYMNGN
PAX1	QLGRRQRVSKRNVKRDYLDR
PAX9	QLGRRQRVSKRTVKRTYLDV
PAX5	HQGRRQRVSKKKVEAEYLEV
PAX8	HQGRRQRVSKKKVEGDYLEV
PROX1	EFYIARAINADERLAQIDWR
PROX2	EFYIARAISGDDCLASLDWC
EN1	AFAEQQRKAEREQRQTQESE
EN2	AFAEQQRKAEREQRQSQESE
NKX1-1	AFYEQVAENKRVCELNLSSE
NKX1-2	AFYEQVAENKRVCELNLSSE
EMX1	AFPSQLRERAHGAEKQGSSE
EMX2	AFPSQLREHAHGAEKQHSSE
VAX1	SFAEQYREMEQGRETERQNE
VAX2	SFAEQYREMEQGRETERQNE
NOTO	MFLEQEEEKVHGKKAQARKE
EVX1	AFREQAREKENRPRCEAANE
EVX2	AFREQAREKENRPRCEAANE
MEOX1	AFKEQREEAENRLRYEVNDE
MEOX2	AFKEQREEAENRLRYEVNDE
VENTX	AFMEQRTEGVQPLEKRREQE
GBX1	AFSEQLEEKEKLTESQHAKE
GBX2	AFSEQLEEKEKLTESQHAKE
GSX1	AFSTQLEEREMRLRIETYNE
GSX2	AFSTQLEEREMRLRIETYNE
HOXA1	NFTKQTEEKEKRARVEASQE
HOXD1	NFTKQTEEKEKRARIENCHD
HOXB1	NFTRQTEEKEKRARVEATEE
HOXA2	AYNTQLEEKEKRPRVEALDE
HOXB2	AYNTQLEEKEKRPRVEALDE
HOXA3	AYSAQVEEKERRPRVENLNE
HOXB3	AYSAQVEEKERRPRVENLNE
HOXD3	AYSAQVEEKERRPRVENLNE
PDX1	AYRAQLEEKEKRPRVEVMNE
HOXA4	AYRQQLEEKERRRRIEHTCE
HOXD4	AYRQQLEEKERRRRIEHTCE
HOXB4	AYRQQLEEKERRRRVEHACE
HOXC4	AYRQQLEEKERRRRIEHSCE
HOXA5	AYRYQLEEKERRRRIEHACE
HOXB5	AYRYQLEEKERRRRIEHACE
HOXC5	SYRYQLEEKERRRRIENNCE
HOXA6	TYRYQLEEKERRRRIENACE
HOXC6	IYRYQLEEKERRRRIENACE
HOXA7	TYRYQLEEKERRRRIEHACE
HOXB7	TYRYQLEEKERRRRIEHTCE
HOXB6	TYRYQLEEKERRRRIEHACE
HOXB8	TYRYQLEEKEPRKRIEHAGE
HOXC8	TYRYQLEEKEPRKRIEHAGE
HOXD8	TYRFQLEEKEPRKRIEHAAE
MNX1	AFSQQLEEHQKRPKFETSME
BARHL1	AFDHQAQERSKVQDMEASND
BARHL2	AFDHQNQERSKVQDMDAAND
NANOG	VFSTQCVNDRKLQQQENINY
NANOGP8	VFSTQCVNDRKLQQQENINY
BARX1	VFELQMGEKRKTPDIDESGQ
BARX2	IFELQMGEKKKTPDLDQSGQ
DBX1	VFDVQKAEKMKKPDKKAKGD
DBX2	VFEDQKAEKMKKTDKKINGE
HLX	VFNLQKGEKRKKPDKQAMGD
BSX	VFDSQSGEKRRTPEVETASE
DLX1	IYSLQQANRRQLPEAEASGQ
DLX6	IYSLQQANHRQLPEAEASGQ
DLX4	IYSLQQHNQRQLPEAQAQGQ
DLX2	IYSFQAAQRRQLPEAEASGQ
DLX5	IYSFQAAQRRQLPEAEASGQ
DLX3	IYSYQAAQRRQLPEAEAQGQ
MSX1	PFTAQLAERKQIAEAESSSE
MSX2	PFTSQLAERKQIAEAESSNE
HMX1	VFRSQFQESTRSAEAGASQE
HMX3	VFRSQFQESTRSSEAGASHE
HMX2	VFRSQYQESTRSSEACSSQE
NKX6-1	TFGQQFAEKTKGPEARYSGE
NKX6-2	TFGQQFAEKTKGPEARYSGE
NKX6-3	TFGHQFAEKTKGPEARYSGE
TLX3	SFRVQCEEKRKSAEAAKSKD
TLX1	SFRLQCEEKRKSAEAAKAKD
TLX2	SFRSQLEERRKSAEAAKARD
NKX2-1	LFQAQYEERRKAPEEHSMHP
NKX2-4	LFQAQYEERRKAPEEHSMHP
NKX2-2	LFKAQYEERRRAPEEHSLRP
NKX2-8	LFKAQLEERRRAPEEQSLRP
NKX2-3	LFQAQFEERRRAPEEHSSKS
NKX2-5	LFQAQYEERRRAPEDQSVKS
NKX2-6	LFQAQLAERRRAPEEHSAQS
NKX3-1	AFHTQIEERKKAPEAHKNKE
NKX3-2	AFHAQFEERRRGPEADASKE
CDX1	VYDHQLEEKERIRRSEANGE
CDX2	VYDHQLEEKERIRRAEATGE
CDX4	VYDHQLEEKERIQRSEVNGE
HOXA10	PYKHQLEEKEMRERLERSHD
HOXD10	PYKHQLEEKEMRERLEKSND
HOXC10	PYKHQLEEKEMRERLEKTND
HOXC9	PYKYQLEEKEMRDRYERVNE
HOXD9	PYKYQLEEKEMRDRYERINE
HOXA9	PYKHQLEEKEMRDRYERLNE
HOXB9	PYKYQLEEKEMRDRHERLNE
HOXA11	PYKYQREEREVKEKLQRMND
HOXD11	PYKYQREEREVKEKLQRMND
HOXC11	PYKFQREEREVKEKLQRMND
HOXC12	PYKLQAEEGEERQRREDRND
HOXD12	PYKQQAEENEERQKKENRND
HOXA13	PYKVQKEEREKKDKRRATNE
HOXC13	PYKVQKEEKEKKEKRRATNE
HOXD13	PYKLQKEENEKKDKRRAANE
HOXB13	PYKGQREEREKKDKRKAASE
LBX1	AFNHQYEEKRKPADDQQQGN
LBX2	AFAQQLEERRKPSEDGTRGN
HHEX	RFNDQIEEKKKPPEKRKMQE
ALX3	TFTFQEEEKVHVYAEQLRDE
ALX4	TFSYQEEEKVHVYAEQMRDE
ALX1	TFSLQEEEKVHVYVEQLREE
ARX	TFSYQEEERAHVFTEEMRDE
PHOX2A	TFSAQKEERVHIYTEELKDE
PHOX2B	TFSAQKEERVHIYTEELKDE
DRGX	TFLQQEAEAVHVFTEEMKNE
PRRX1	TFSSQQAERVHAFVEDRRNE
PRRX2	TFSSQQAERVHAFVEERRNE
RAX	TFTYQHEERAHVYSEEGKNE
RAX2	TFTYQHQERAHVYSEEAKHE
ISX	TFTEQHEEKIHVHISQARNE
OTX1	TFRSQDVEALRIFMEELKNE
OTX2	TFRAQDVEALRIFMEELKNE
CRX	TFRSQEEEALQVYAEELKNE
VSX1	VFAHQEEEKAHVYAEMVKEE
VSX2	IFSYQEEEKAHVYAEMMKEE
UNCX	NFGWQEEEKAHVFMEALRDE
DMBX1	AFAQQEAEKTHVVMERMCNE
SHOX	NFLEQNEERLHAFMEEQRGE
SHOX2	NFLEQNEERLHAFMEEQRGE
OTP	RFPAQNEERSHIFMEELRGE
GSC	IFDEQEAENLKVGTEQRKHE
GSC2	IFEEQQAEALQVSTERGRRE
PITX2	HFSQQQEEATRMSTEEVWNE
PITX3	HFSQQQEEATRMSTEEVWNE
PITX1	HFSQQQEEATRMSMEEVWNE
DUX1_HUMAN	AIGSQALLRARIAAEEREGE
DUX3_HUMAN	AIGSQALLRARIPAEEREGE
DUX4	AVGSQALLRARIAAEEREGE
DUXA	TYASQHTIKAPIDSEEKEGE
MIXL1	SFAEQQLELVRIHLERALLE
PROP1	TFPVQEQESAQIWAESRDGE
SEBOX	TFKGQLEERAPISTEHWVCE
ESX1	AFQFQQEENFQVVAERARNE
HESX1	AFQNQEVENVCIDIEDQKNE
RHOXF2	AFPLQQEERIQEFLRRRSNE
RHOXF2B	AFPLQQEECIQEFLRRRSNE
RHOXF1	KFLLQEEESVQVPTREENGE
NOBOX	LYSDQEEEKIHSDKREQTGS
LEUTX	----------MLATGKSKQL
ARGFX	SFHQQEEEALMRNLEKLRDE
DPRX	MFKKQEDNILPPSLKESKDP
POU5F1B	SINRVGNENLP-LQSHQQGK
POU6F1	SFPQAEANAYPGQETEKENR
ISL1	VLEKQHTRTCPALMEQEMGP
ISL2	VLEKQHTRTCPALMEQEMGP
LHX2	SFHHQRTKSYHAKDKQQKGK
LHX9	SFHHQRTKSYHAKDKQQKGK
LHX6	SFAEQQVQAQNAQTQKDMGR
LHX8	SFADQQVQAQNAQTQKERGR
ZFHX2	TIPEQEIYRWSRKMDCEEGK
LHX1	TIAKQETKAAPRHIEQQEGM
LHX5	TIAKQETKAAPRHIEQQEGM
LHX3	TIAKQETKSAPRHVEQSEGM
LHX4	TIAKQETKNAPRHVEQSEGM
LMX1A	ILTQQRAKASSRKVETAEGV
LMX1B	ILTQQRAKASSRKVETAEGV
HNF1A	KWPASQIFQAKKEEETEENE
HNF1B	KWPASQIYQAKKEEEAEENE
ANHX	FPEVRKLNFATKAEENLESP
IRX1	RETSTKALNEPKGEIMIIKL
IRX3	RETSTKALNEPKGEIMIIKL
IRX6	RETSTKALNEPKGEIMIIKL
IRX4	RETSTKALQEPKGEIMIIKL
IRX2	RDTATKALNEPKGEIMIIKL
IRX5	RDTATKALNEPKGEIMIIKL
MKX	QDARPKQLYKPKTEILLGQL
MEIS1	KVTNIRALFQPEEQKQQDGI
MEIS2	KVTNIRALFQPEEQKQQDGI
MEIS3	---------WPEEQKQQDGI
PKNOX1	KHTNVRSLFQPEDEKQAQNL
PKNOX2	KHTNIRSLFQPEDERQAQNL
TGIF1	KEVQIRDLYEAEQEALQQHT
TGIF2	KEVKIRDLYLAEQELSGQNV
TGIF2LX	AEVKIRDMYKAEEEQMEKNL
TGIF2LY	AEVKIRDMYKAEEEQMEKNL
PBX1	KQTEINEFYSPEEAEEKKGV
PBX3	KQTEINEFYSPEEAEEKKSV
PBX2	KQTEVNEFYSPEEAEEKKGV
PBX4	KQTEVNEFYSPEEAEERKGI
SIX1	EKRGVREYAHPPREREEAGT
SIX2	EKRSVREYAHPPREREEAGT
SIX3	ERRSLREYLQPPSKREQAGP
SIX6	ERRHLREYLQPPSKREQAGP
SIX4	EKRNAKEYKQRPAERHKIGL
SIX5	ERRAAKAYRGRPDERRTLGL
HMBOX1	TWKECAVESYQEAKEENANS
ZHX1	KKKEQAEKVSQDSEIRKIGK
ZHX2	KKKEQAHKASQDAEYREVGR
ZHX3	KKHEQSAKGSQQSEEHKVGT
HOMEZ	RKKEQAIKSFQREDQKQIGR
ADNP	--EARSFTKYPRREEKASWK
ADNP2	RSEEKQFKDYPKKEELSLWK
HDX	QFDRDATKKYMGSVREEAAC
NANOGNB	LVKSLHTWAKRIQELSFEDH
SETDB1	RNPLVYMTRFICMICDLFLM
SETDB2	KNPQLCRHKLSSVVCNLFTN
BAZ2A	AEERLHEVIGWRFVVHVRRH
BAZ2B	TRERIYETIGAKYVIMISRN
MBD2	SRMCPPEEIKYKKLDLSFDD
MBD3	-----------KKLDLTFDD
MECP2	RMYDPEKLQKYAKLDTLDPD
MBD4	TTERKCVVQRYKKLETLKPD
LIN28B	GHCWFMISIIVF--PVFTFS
LIN28A	GICWFMLSTPVH--AVFTFS
YBX1	VTVWFNINNTVKPYTVFDVG
YBX3	VTVWFNINNTVKPYTVFDVG
YBX2	VTVWFNINNTVKPFTVFDVG
PIN1	-XAEEPRMR-GRFRVLQPH-
MBD6	-GPATICVE-LELTTCCGLV
MYRF	SDKPVTVGRHETKGKPDQRF
MYRFL	SDKIITVGRHETKGKPDQRF
ZZZ3	LVQKIRQADLRT-AKQSRVK
MYSM1	KIKLARTSKIRT-VLQSYAQ
MYB	PKDRQRSAKLRIWHNHTSWE
MYBL1	PKDRQRSAKLRIWHNHSSWE
MYBL2	PKDKKQTAKLRLWHNHSCWE
SNAPC4	YPDKADFREVRSYLRRGRWL
TERF2	KVSWQNASKYVNTAVMDRWT
TERF1	AWDNRNSLLYNNTSVMDRWT
NFX1	PCCC-SDHTECHSCGR---H
NFXL1	VCCCSCCHQRCCDCGRGCRH
CDC5L	VNDIMQSASLKSWYEWTEWR
MTERF4	RKCFTRDQLYQYKHPDKSEL
TERB1	NEVYKHNLWFQQKAVDHKYK
DMTF1	KPIKIDAGALSARLMKKWTE
TTF1	DTEVSASETKKASPQEEVDK
MTERF3	GQLLRTSPVEKVKHNEHMIR
MTERF1	DKVFLVKFKPLIANIERSTN
MTERF2	EKVILVLLLQFIIKETFLQQ
MYPOP	RFNIR--YGQRVVWDGAKIG
MSANTD4	NVTTT--FSQTTAWEEQCVA
GRHL1	NNESPLESIFICLFS-VNTK
GRHL2	GTESALESIFVCLFS-VMTK
GRHL3	SDGAPLTNVFVCLFS-VNTK
TFCP2	LPCSEMDKTFPCIFTHERTK
UBP1	PPCSEMDKSFPCIFTHERTK
TFCP2L1	PPCSELEKTFPCIFTHERTK
POU3F2	PTQQGYNVCNEVSGAHKASS
POU3F3	PTQQGYNVCNEVSGAHKANS
POU3F1	PSQQGYNVCNEVGGAHKAGS
POU3F4	PTQQGYNVCNEVSGVHKASS
POU2F1	SDQTGYNDCENTNVASESMQ
POU2F2	SDQTGYNDCENTNFASASLQ
POU2F3	SDKTGYNDCENTNLTRDSMQ
POU5F1	ALQLGFKVCQENRGNLQLHQ
POU5F2	-IQEGFKVWKKRRNSFRPHC
POU1F1	PEKEAHSECSEIADAHESRE
POU4F1	TDARAKPSIQEAPRSYVSAK
POU4F2	ADARAKPSIQEAPRSYISAK
POU4F3	SDARAKPSIQEAPRSYISAK
POU6F2	VNEASEPAQEAPQEIHKGEK
PAX3	INNHRHCRVKEEILLVRVR-
PAX7	INNHRHCRVKEEILLHRVRL
PAX2	VNDQRHCRVDEEILLINVRL
PAX6	VNDQQNCRVSQEILLVNVRI
PAX4	VNLQKNCRLAQEILCLQVRA
CUX1	TRKEKQITISGVKRAQPETS
CUX2	TRKEKQITISSVRKAQQEFN
ONECUT1	TQTTEQIKRESLHAIKKIQS
ONECUT2	TQTAEQIKRESLFAIKKIQT
ONECUT3	TQTAEQIKRESLIAIKKVQN
SATB1	NDQQEQLNSLATQSFQEQAY
SATB2	TDQQEQLNCLVTQSFHQHAH
TBP	PAMRILFVQVESIYRIIGLA
TBPL2	PAMRILFVQVESIYRVIGLS
TBPL1	-KMKLTWLVMPACYRKIGVA
NFATC1	LEMLQDLSPRGRTDIRVHPL
NFATC2	MKGLQEIGPRGRTDIRVHSV
NFATC3	NKNLQDYAPSGRTDIRVHPL
NFATC4	SKTLQENSTAGRTDIRVHGV
NFAT5	N-VLQG-EGTGRAGSKVNKL
NFKB1	VAIVQILVLFMEQTKMMFSR
NFKB2	EAEVDPAALMLELKKMRFSP
REL	YGRITYPLRKINDIECCFEA
RELA	TGRISHPHQEIN--GYCTPR
RELB	GVTACHVHQEID-HQVCSQR
SMYD3	SCVFNARRDDTWEELALQSP
MEF2A	RMDERRQVTTKLKVCDEIAI
MEF2C	RMDERRQVTTKLKVCDEIAI
MEF2D	RTDERRQVTTKLKVCDEIAI
MEF2B	RLDQRRQVTTKLKVCDEIAI
BORCS8-MEF2B	RLDQRRQVTTKLKVCDEIAI
SRF	FDNKLRYTTSKIKTTGQVLL
HSF1	TVSDPTDALCPFGVPKHNNA
HSF4	AVGDPTDHLRPSSVPQHSNA
HSF2	TVEETTNEFTQLQIPKHNNA
HSFY1	KVESDQFKSSEIEIETTDAK
HSFY2	KVESDQFKSSEIEIETTDAK
HSFX1	RVSSNQFSSWDIKIKRTTSK
HSFX2	RVSSNQFSSWDIKIKRTTSK
HSF5	RVNSPRYRSRGIPLSPTTST
NAIF1	PAAKSAWHGLVVCEKKWSDK
MSANTD1	MVWEEFDELQRMKGRRLGEI
MSANTD3	LALVEYKYVEKLRAEYSVSR
TBX2	EAKLPFSKILVADCYKVPEM
TBX3	EAKRPFSKILIADCYKVPEM
TBX4	HEKASYTKILVADHYKVPAM
TBX5	HERVSYTKILVADHYKVPAM
TBX1	EMKLTFFMMLVVDYYAVPAT
TBX10	EMKLPFLLALILDYYAVPAT
TBX15	QCAIAMTHYIVVNYYVVSPV
TBX18	QGAIAMSHYIVVNYYVVSPV
TBX22	QGSISVKGHVVVSYYVVHLI
TBX20	ETKLTISEIVVVNYYAVPPL
TBX6	ENRVACTELFIVGAYRPPRL
T	EESLVLSNSFVANHWKPPQA
TBX19	EDAVVLTNSLVTSHWKPVSS
EOMES	CNRHFLNTNVVAPNWRTNNQ
TBR1	CNRHFLSTNIIAPNWRPTNQ
TBX21	NNHHFLATRMVVQHWRQGSP
TEAD1	PIDPCGIGGRAYKLTGVVLR
TEAD4	PIDPCGIGGRAYKLTGVVLR
TEAD3	GLDPCGIGGRAYKLTGVVLR
TEAD2	DGGPCGIGGRAYKLTGVVLR
STAT1	PTHTELNHMNTGLERHNT-E
STAT4	PTHTELVNMSSGLERHSG-E
STAT3	PMHTELNNMNNGLEKHCAND
STAT2	PQTTEGNNLTQQLDGYSGSK
STAT5A	IIETLNNSLNMYQGLSLADR
STAT5B	IIETLNNSLNMYQGLSLSDR
STAT6	LVETFLATINLNINCSLCEK
LIN54	---NNGNTNN------GCEY
E2F2	YDTGLKIYLLSEEDVNWEVD
E2F3	YDTGLKIQLLSQPDVNKEVK
E2F1	YETNLKLELLSHADVNWEVK
E2F4	HEKGLTVSLLQEKDVKLDTA
E2F5	-------XLLQEKDVKADTA
E2F6	FDVVYRMDLVRSPGINKTKG
E2F7	KQKGLQLARYPSEKTDEVSG
E2F8	KEKGLHLARYPPVNDDEEEN
TFDP1	NGKRHMCEKVQ-RKTNEDEV
TFDP2	NGKRHMCEKVQ-RKTNEDEV
TFDP3	NGMCRMWETVQ-RKTQEGEV
TFAP2A	RLSSSKVTVAELPPCSLGVR
TFAP2B	RLSSSKVTVGELPPCSLGVR
TFAP2E	RLSSSKVTVGELPPCSLGVR
TFAP2C	RLSSSKVTVAELPPCSLGVR
TFAP2D	RLSSSKVTIAELPPCSLGIR
GTF2IRD2	RAFGTTVVVPLRDQAVQLLW
GTF2IRD2B	RAFGTTVVVPLRDQAVQLLW
GTF2I	RTFGKSTVVPLRDQAVQLLW
GTF2IRD1	RMFGRASVLPLREPLLQLLK
GMEB1	MITLWKKVPGCVKFDQSKKA
GMEB2	AITIWRKVPGCVQYEHSKKA
SP140	KPTHKKKQGIIQTEGKTTRS
SP140L	QPTHKEKEGTIQTEGKTMRS
SP100	KSTYKERKGTIQSEKKTRKS
SP110	HSTYKKKKGSIRNEGTTNKN
DEAF1	YSRYKNRGGGIK-QENSTKS
THAP1	SSKKDKPSHKRPSLKEAVKS
THAP3	SACRRKQTHRRPELKELIQT
THAP2	NAAKHINSHR-PKRKERVKT
THAP8	YRSDNRPSYKDGPRQAQMCQ
THAP4	CASEKRASHRDSKRIQKVKS
THAP6	CSAKLKGTHVENIK-KLMKD
THAP9	SSSRERGSHQTIQR-KRVPA
THAP7	HSCRNRGSHRDNPRGLACEI
THAP12	FATTQSDAFR-PARQKECKY
AIRE	-GAIQQVEGGIQVGEFP--S
THAP10	RVGLFRFKRAWDRFRGAWDS
THAP11	TCYRDKAHYTAELRLWNSTH
POGK	--MKLMVEAECQAAQFLKVD
SKOR2	ADCIPARNSRKCSYNMSNDA
ATF4	KETQEQEAGCKEEKEAKDSA
ATF5	KDSQEGEAGCQGEAREKESE
BATF	QEIQKADTLSEDEKAARKQT
BATF3	REVKKADKEYESEQTMRGKT
BATF2	LQAQKADAQHESEKLARQSQ
HLF	ARMDKENQIASFEKSARADR
TEF	TKVDKENQIAAFEKTARAER
DBP	SYEDKENQVAAFEKALRVAR
NFIL3	EREENDLVNLIAGEATKLSK
ATF2	KEAQWVQSKAEDSSGQQTLR
CREB5	KEAQWVMSKAEETQMQQSMK
ATF3	REINKTECKPR---------
JDP2	REVNRTEFRSERELAEKEEK
FOSB	VELNLTDRATDQEEAEEAEQ
FOSL2	IELNLTEKATEEEESGQAEQ
FOS	IEMNLTDTATDQEDSAQANL
FOSL1	VELNLTDFATDKEDSGQEEQ
CEBPA	VEIDRNVEQVLETSDRREQS
CEBPE	LEIDRILEQVLEMAERREQT
CEBPB	IEIDRNLEHVLETAERQEQS
CEBPD	QEIDRNQEQLVESAEKHEQT
CEBPG	QEMLKAQDQVNQKEEREKLT
ATF1	IMERYVKCNVAVENKTIKTK
CREB1	VMERYVKCNVAVENKTIKAK
CREM	LMERYVKCSVAVEVKKIETK
CREBL2	AEQARYQYEVSSERCAREMK
ATF6	QIEKYMLGALKALSEQKGTK
ATF6B	QIERYLQGALQALAQQRAAR
CREB3	RIRRYVGGSVLKTAMEQQLE
CREB3L4	RIQRYIDGSVAASAQEQQEE
CREB3L3	RIQKYIDGTMSATAQEQLHE
CREB3L1	RIIRYVECKVETTSNEWETE
CREB3L2	RIIRYMDSKVESSTLEREVE
CREBZF	PAALYVMGSVRGAAQERREG
BACH1	RSIKCIQNSIEKQSESLDHL
BACH2	RSIKCIQNCIRKVCEKLNQK
NFE2	RGVKTIVQRLERTNERLGED
NFE2L2	RGVKNIVEQLDHKDEKLGED
NFE2L1	RGMKTILNRVEDQRARLVEL
NFE2L3	RGVKIILNDVCNQAETKAQN
JUN	RMIKRIAREVKTKASEANMR
JUND	RLIKRISREVKTKSTEASLR
JUNB	RLLKRIARDVKTKAAGSGLR
XBP1	RLVDRMSEQVVDEEQKLQLR
MAF	RLGFQRHVSKNQLQDHKSRV
MAFB	RLGYQKHHNKTQIQEQKSRA
MAFA	RLGFQRHISKCQQSEQKGRA
NRL	RLGSQRRGARARAADARARA
MAFG	RLGVQKEEKKAEQQEKAASK
MAFK	RLGIQKEERRVEQQEKASSR
MAFF	RLGVQKEEKKSEERDKAAAR
DDIT3	KQSQKEQERVAQAEERKERT
FAM200B	CKPENDRQ-CVNAN--SLKL
ZBED9	-IDEVLKQ-CIDAN--AMKL
ZBED5	YGNDAPHQ-CVKSN--SLRL
ZBED6	IWHFHVDQYCNRSRPSHLQL
ZBED4	PWKFFISRDCINSRNKDLIM
ZBED2	EWEFHLAA-CRRSRPVNVWL
ZBED3	EWGFHLAG-CREGRPFHAWL
ARID3A	FDDFSFMKRNRMQVFLYVGV
ARID3B	FDDFVFMKRNRMQIYLYKGV
ARID3C	FDDFSFMKRNRMQVYLFRGV
ARID2	FDERQFHSRKKVKEHLYTGA
ARID5B	FVAYKYMERERLKQWMFQGE
ARID5A	FVSYKFMERERLKQWIYKGE
C11orf95	YMDNPARG-CMSATSIKRHR
KDM5B	FDQAKYWLQLKVKIFLNKGA
SGSM2	VWDALVVFSCIQSG-TLVG-
ZBED1	KWKFGFDNAQWYICIYSGSL
ZNF277	NTNHG----CMELGVLNHAL
ZNF512	IDKSVSCTCCHKRSMYHVKH
GZF1	TEGRSQPSAKTMVDGTQNCM
ZBTB44	PTGRTRIQNKQMQDGTRAKR
HIC1	ASDSKDPATRQEPTGTQRSA
HIC2	SVETKDPATRQEPNGTQRSA
ZBTB16	EFGCRDESTKSKENGSLKVE
ZBTB32	------------ASGSLKVS
PRDM1	QTNGTQLAHQKYEQHSSTLQ
BCL6	NIGQNRPANKTTKEGVQVIP
BCL6B	SIGRNRPANKTSKEGVQVIP
PRDM12	VIHGNSRSNRSMVRNSQSLK
SALL2	NVGRTTRGNKVFKKGSTRVS
SALL4	SVGRTTKGNKVFQKGSTKVS
ZBTB17	PHDKNQVGNKALKRGTTSIV
BCL11A	NLDATQASKKRMTEGKNCSK
BCL11B	QLDASQASKKRMTEGKNCSK
HIVEP2	PYSAAKPSVKKIPIGKTKSI
CTCF	SMDAVEVSKKRIQSSRDTTE
CTCFL	SMKAVEASKKRVQCSRDTTE
ZFP64	QIPARNSSQTVLQWSKISVK
IKZF1	DIGIIGPNVMVKQNGTQKLK
IKZF2	DVGVIGPNVMVKHNGTQKLK
IKZF3	DVGSISFNVMVKQNGTQKLK
REST	ELPSSQKTHTRMKDSSNQVN
ZBTB7A	PIEVQGAGKPRIENKTRQKL
ZBTB7C	PIHVMGAGKPRMMTETRQKL
ZBTB7B	PVHIHGAGKPRMAEGTRNKS
RREB1	SIGSSSASSDRMKTGTTNTE
ZBTB20	SIWSSLKDYIKMQSNTQKLE
ZBTB45	AVWSSLRDYLKMQAATQKTP
E4F1	KLGSRTKGSIRHKSGRESGA
PRDM4	DFSASDPSNRTLRTDTQKIK
ZBTB2	------------ETGIQKIK
PLAG1	NYEMHRKDHKNLKEGNTKLT
PLAGL2	MYDMHRKDHRNLHSGNTKMS
ZBTB22	CHGASHKSMDRVDPNKMKT-
ZBTB43	CQGSTHKSQDRMGGGKMKI-
PRDM15	EQGSARKDMKEMLAGKTKLE
SCRT1	PTGVVSMPAAMLKGGSRPSG
SCRT2	PTGAVSMPAAMLKGGSRPSG
SNAI1	KYNELSLGAKMIVGGSRPTS
SNAI2	KYDEVSLGAKMIVKGSRPTS
SNAI3	KYDETSLGAKMITKGSRPTA
ZBTB26	LLGTTQKGNHRMQKGSQKLK
ZBTB6	LQGTTQKKNNRIQTLTAKIK
ZBTB12	PRGQNHSSNNRMSGGTQKLR
ZFP57	TLDTCDASGSRRSSGRDQIC
GFI1	EMGTGHAVSEQKDKGKRSIP
GFI1B	DIGTGHAVSEQTERGKRSIP
FEZF1	KVGGRQASTCRKKNGNRSIV
ZBTB14	QAGTSDEGRRKEVETTTQIS
GLI4	GQGASHSSHTQLKGGSQSLA
ZKSCAN7	SEGARHSSHIQQKNATQSIE
ZFP3	NEGAKHSSGIRQLNGGQSIE
ZKSCAN1	NEGASHSSNILQENGSQSIE
ZKSCAN3	EEGASHSSDIKQEDGSQSIQ
ZIK1	SEGLRQNSSVDQESGSQKVK
RBAK	NEGTCQKLHTQLESGCQKNP
ZFP1	PEGATHQSNIVQESGAQKIE
ZFP14	KEGARVHQQARQEKGRQCIE
ZFP82	KEGARVRGQTLQVKGRQYIE
ZFP28	DVHSRYGSSTVQEDRSHHIE
ZFP69	EEGARHRSSNQHVDQSQNTT
ZFP69B	KEGTRHPSSTQVERESQSTT
ZFP90	NLGSRHGTSTQEQKGSRCTE
ZIM3	KTGASWKSSINEQNERQNVQ
HKR1	TEGHSWKSNKTQVLGSLKSV
PRDM9	REGGSWQSVLTQVRGSWQTV
MZF1	VEGRGRRSVLQRAAGRQRIA
ZFP92	PEGLRRSFALEQAPSTRSIA
OSR1	KFGHTKSYNLIETDHRRQIK
OSR2	KFGHTKSYNLIETDHRRQIK
ZIM2	EFKTSTQVARREEKAYLMTE
ZKSCAN5	EEGSNQRVHTQQTPGRVRVK
MECOM	DQPANWKSNIRQEEAFTDQA
PRDM16	DQPANWKSNIRQEEVFTDQA
ZBTB49	EIGRAASGDQRI-------L
OVOL1	SLDATQRCSESL--------
OVOL2	NVNATQRCSESLY------V
MYNN	ELDGAQKCQVFSY------K
PRDM14	STGCSQSSSNKMQVTTASQK
ZBTB37	IYASNQKGSDRMVRGTRKKH
PRDM6	--SSSQPSERNVKGGAGATK
ZBTB48	EFSATQKANNMLQHGRTQTS
ZBTB11	SVGSHRGSGSKFHTEFEAKR
ZBTB33	IVKSVCLTSRRFPREPLAHQ
EGR1	ESDRSRSDETRIQRINFSTA
EGR2	EGDRSRSDETRIQRINFSTA
EGR3	EGDRSRSDETRLQRISFSTA
EGR4	ESVSARSDENRLQRINFSTA
WT1	KDERSRSDQKRQQKTKFSTS
GTF3A	PDSNSKAWKDALVDGAFITV
MTF1	EGPTSTAGNRTQVNGAFLVE
KLF2	AGGTTKSSHKALHNGKFAKQ
KLF4	AGGTTKSSHKALHDGKFAKQ
KLF1	PGGSTKSSHKALATGRFAKR
KLF12	EGNVTKSSHKARKTGKFAKK
KLF3	DGNVTKSSHKARKTGKFAKQ
KLF8	AGSVTKSSHKARKTGKFAKR
KLF5	PGTVTKSSHKALKTGRFAKQ
KLF6	NGRVTKSSHKAQ--------
KLF7	NGRVTKSSHKAQKSGRFAKK
KLF10	PGGTFKSSHKATSSGRFATA
KLF11	PGRTFKSSHKALNSGKFATV
KLF13	AGEVGKSSHKALASDKFATS
KLF9	SGGVGKSSHKAYPTDKFSTR
KLF14	PGTAYKSSHKSQSDDKFTTS
KLF16	PDAAYKSSHKSLADGKFATS
KLF15	PGSMTKSSHKALATGRFSSQ
SP3	PGGVGKTSHRALVNYRFTTV
SP4	EGGVGKTSHRALINFRFTTE
SP1	QGGVGKTSHRALMTYRFTTA
SP8	PGGVGKTSHKALVNFRFTTA
SP9	PGGVGKTSHKALVNFRFTTA
SP5	PGGVGKTSHKALVNFSFTTA
SP7	PGGVGKASHKALVNFRFTTT
SP2	PDGTRKTSLRAVVNFRFTTE
KLF17	ENGATKRSHVSQSNSSFFVK
GLI2	EGSASRLENKTLVEGAFSTI
GLI3	EGTASRLENKTLVEGAFSTV
GLI1	EGRSSRLENKTLMEGAFSTV
GLIS1	EGSASRLENKILLQGAFSTA
GLIS3	EGEASRLENKILLQGAFSTA
GLIS2	PTSSSRLENKINVPGRYSTY
ZIC1	PGGVARSENKIKKEGRFAVL
ZIC2	PGGVARSENKIKQEGRFAVL
ZIC3	PGGIARSENKIKKEGRFAVI
ZIC4	PGGVARSENKIKREGRFAVT
ZIC5	PGGVARSENKIKKEGKFAVY
YY1	AEGAVESSKKRQQTGRFSIV
YY2	AEGALESSKRRQQTGRFSIV
ZFP42	AEGAVESSKKRFRTGRFSIV
ZFX	TDDTNKKISHNLEDGSHAKK
MAZ	PVQRKRKDRSYVNSGSRPVK
VEZF1	PINRKRKDRTYVTSGSRPVK
PATZ1	PVGRKRKDRSYVIQGSRPV-
HINFP	SHSRATERLRDMKPDPLPRK
ATF7	PGGRTNEDHAVKPEQERNAR
AC023509.3	PGGRTNEDHAVKPEQERNAR
INSM1	PEAVSCPANASRLPGASKLP
ZKSCAN2	AWCPATRARECKSKNGVLEC
ZSCAN29	NRYTPEANWEYTSKNGAPEC
ZSCAN20	TQREKLSTCALYKTKSFSRS
ZFHX3	KHKDHCDRYSTCWGQVKTSA
ZFHX4	KHKDHCDRYTTCPYYNRDQR
ZNF143	SDNKSKTSGDTNKNVRIVTV
ZNF76	PELKAKTSGDTNKNVRIVTV
ZNF410	TEGRTVWPAHGNKNRRILEA
ZNF276	PQGAVRGADGKHLVQMRQEV
ZNF704	LKNKVSTAAG----------
ZNF653	PEGQVVALSSNHEVRRTQEI
ZNF692	DPGRISNRQYSNVIRRIQEI
ZNF343	VLERSCDKSTSTIIERTVGE
ZNF589	----------SQIIQRTVGE
ZNF133	VGVHSSQNSTSNIRQRTVGE
ZNF169	VPERGCQKASVTIRQRTLPQ
ZNF337	VREQGIQKSTSSNKLRAFRD
ZNF382	QNEKAIQKTTAITVHR----
ZNF567	IKEKSHQKANTTVAQRTEPH
ZNF707	YADKARTKENGFTRQRT---
ZNF101	KKQKAISAGY----IRSQQE
ZNF77	QKHKATCYSSTYRRVKTQKE
ZNF555	EKQKTIYPQSISRKMRTEKQ
ZNF440	QKEKATCPRYNSQREKIKKQ
ZNF69	QKEKATCPQYNSQREKTKKQ
ZNF439	QKEKAMCPRYKSQREKTKKQ
ZNF433	EKEKAKCPSSSSQTEKTKNQ
ZNF124	EKHKARYSNCSSQKEKTVNN
ZNF136	EKQKASYLPSPSRRMIKKKV
ZNF627	EKQKASCSKYASRRMIKKKV
ZNF564	KKVRAIFPSYPSRRMIKKQV
ZNF441	KKQKAICCTYKSQRMIMKKI
ZNF791	KKEKAIFPSFPARVVRVKKE
ZNF44	TKQKACHLGSSSRRMMAKTV
ZNF563	EKQKTHHLGSSSRRMIMKKI
ZNF442	EKQKAHHLGSSSRSMIMKKV
ZNF799	AQQKAHHLGSSSRRMTMKKI
ZNF823	AKQKTYHHTSSSRSMITKKI
ZNF443	AQQKAHHLGSSSRSMIMKKV
ZNF490	KKQKAIYYQPSSRKVKTTKK
ZNF669	EKEKTRFSCSSSCNRSTEKQ
ZNF705E	QNLKATNCFH---REKTKHQ
ZNF705G	QNLKATNCFH---REKTKHQ
ZNF596	GLLKASKCSYSVKRERIEHV
ZNF333	ESQKTTRNFNSSKTLRTENQ
ZNF891	ENQKAKR---TSKAMRTENQ
ZNF177	----------SHNVKRTDKE
ZNF317	ATQKARWKSNSIKTMNSGDL
ZNF121	QKERAAGRSGSCKNFRIKKE
ZNF778	EKQKATGRSGSCNKIQIEKD
ZNF561	KTYKATRSTQTSIQTRIEVE
ZNF562	KTEKATRSTHSTTQRRIEVE
ZNF266	KKDKATQNSDSNSGLRIELE
ZNF846	EKEKAIHSSYSMSQVRIEKE
ZNF114	EGKKARYSLHSSYTIRSKKT
ZNF557	ENDKTSSRSYSITRKRVVNQ
ZNF558	-------RSYCNKSKRIENQ
ZNF554	----------STTRLRTGGE
ZNF667	RNKKVNRHSSSFIEQRIQEE
ZNF10	TNQKSVHSSRSHVVHRIEKD
ZNF180	ENQKSRQSYKYKVAQRTENQ
ZNF205	TPAKSSHHSTSAVTQRTPPE
ZNF436	KNEKSCRLSHSDIKYRVKDE
ZNF222	NEKKAMHNFQSYLVQRVKEE
ZNF223	NEARAIHDFQSYLIQRVKDK
ZNF225	IEKKAIHDSQSANSRMVKEE
ZNF284	IEEKAIHNSQSANSCMDKEE
ZNF224	NEEKAIHDSQSANSRMIKEE
ZNF18	KDYKGSDFSGSSDKQRS---
ZNF235	KGDKRSCSSNSSQSQRVRNV
ZNF45	KEEKGCRASNSNLAQRGKGT
ZNF285	KEEKGDQSSNTHHIQRVKNV
ZNF214	KNQKSNRSSVSNQIQRVKDD
ZNF263	KPEEIAHSSNSHVIERTELT
ZNF449	KLEKSCHGSSTATLQRTKNY
ZNF322	LSEKCSRSTNSAIVKRVKGA
ZNF394	KEEETHISN-SDFKHRIGSV
ZNF768	KPHKAGDSSYSAIPARSKPE
ZNF774	EPEKTGRKPHSDIKQRTKPE
ZNF24	----------SAILQRIGVE
ZNF396	----------SAILQRIADE
ZNF189	LIEKSSRSSFSGIQQRIKDE
ZNF16	KSDKASQSSSSAIQQGVAHE
ZNF792	ESDKFSQRSNASIQQIV-GE
ZNF22	KTEKSSQSSTSNIQQRIQDE
ZNF34	KGEKHSAYSSSNIQQRIKNE
ZNF3	ESDKTSCSSASTTHQRIANE
ZNF594	QTEKARRRSLSDLRHRIVNK
ZNF79	ESDKARHSANAAIQQRIRAA
ZNF883	PNEKASHISAPAIQQRIENA
ZNF12	VHDKTSQKSASYTVYRTENE
ZNF25	ETEKFYVKAYSHKTQRSEKE
ZNF33A	EYEKSRVTSHSLTRQIIEYE
ZNF33B	EYEKSCMNSHSVTRQIIEYE
ZNF248	INEKSCVKSNSVTKQRI---
ZNF37A	EYAKALRKSDSGTELRRGNE
ZNF334	EKENASKKSYSANVRRSESQ
ZNF157	ESEKTRVKISMTNNQRTQNE
ZNF182	KTEKSNEKSTSYMLQRGENE
ZNF674	VDKKAKSSYHSHSVHRTERR
ZNF300	ETEKACEKSHTEITQLVETE
ZNF84	GSDKAFEKSESHISQMTISK
ZNF605	GGEKASRNSLSEIRQKI-IQ
ZNF350	RSLKASRKFMGNIVQRIINE
ZNF613	HSLKASKRSRGNIVQRIINE
ZNF649	HSLKAYKRYRSLVVQRTTSE
ZNF614	ISEKGTMKRYRTVIQRTINE
ZNF615	VGEKGPAKIRSMIAQRTINE
ZNF432	LSEKGTVKSMSGMLQRTINE
ZNF26	KSEKARSKSYEQTALRAGSE
ZNF782	ENEKSSHMSGSQRGHRIKNH
ZNF793	-SHKATQNPASTIKQRIEFF
ZNF175	VIEQAIQKAHSHNIQKIVSE
ZNF585A	IIEQAIQKTHSHNIQKIEHE
ZNF41	VADKAIQKSHTNTTQKTMAE
ZNF81	ITQQAIQKAHSNNTQKSIAE
ZNF484	ITVKATDRSNSTSMQRIVTE
ZNF684	VNDKAMHKAQSSNQVKSEKE
ZNF146	ENEKSSQKENSNTEEKIKSE
ZNF260	KSEKASQKENSNTEEKIKNE
ZNF132	EDEKASNRSHSAIQWRVESE
ZNF584	ESKKTSVLSTSGYQWKVESL
ZNF17	YCEKFMDSCTSTIIQRVENK
ZNF548	EREKSMYNYRSTIKQRVKND
ZNF547	ENEKALCKSHSNFRYRIGSE
ZNF749	KSEKASLKHNAHVGQKIETQ
ZNF134	ESEKTSRKDNSTVQESIDSD
ZNF304	KNKKASRKDTDTVQQIIESE
ZNF671	ESEKFRQISGHTVLQRTESE
ZNF419	TSEKARHNSTSNIKWRVKSD
ZNF658	ENEKACQNSNTHSVQRVEND
ZNF211	ESEKSSQNFSSSSSRKVVGE
ZNF586	ENEKSAYTSSSSLQQRVESE
ZNF154	ESEKSSQRSASSIEHRVKSE
ZNF530	ESEKASCNIYSGFRRRAESE
ZNF32	EQEKSRQKGSGSAVERLEAI
ZNF776	EDEKSSHKRSSHKEQRVEKE
ZNF417	HGEKSRQKFCYHLVERVAEV
ZNF587	HGEKSRQKFCYHLVERVAEV
ZNF418	EEEKCTQKGNGNIQQRSERE
ZNF552	----------SHLVQRIEEV
ZNF416	EGEKLRQSFSTTNKHKVVGE
ZNF549	QSEKSIYKQSQTLKHKIESE
ZNF232	ESEKTIYNSHAHVQQRIENE
ZNF35	ENEKTTRSSNSHIVQRIDSE
ZNF250	RNEKTSVKRTSTMNERIAYE
ZNF354C	RREKASQCSTTSAEQRFTLE
ZNF662	----------TSTQQRITKE
ZNF197	KNEKVSQNAYTYIDQRLKKE
ZNF501	VSESCRKQSNPSIKQRIKTE
ZNF502	ISESSRKHSNPSIKQRIKKE
ZNF287	INEKTSQSTHSTIQQTTINI
ZNF660	KKEKASHSSNSGISHRVSIE
ZNF8	MKEKASQNSSSSGRKRTTSV
ZNF100	KEEKANQSSTSQTAKMIKEE
ZNF430	KEEKANQSSTPKTAKVIKEE
ZNF431	KEEKANRFSYSITTKRIKEE
ZNF714	KEEKANRFSYSNTKKIIKEE
ZNF257	QEEKANRSSHSHSQKIIKEE
ZNF492	KEEKASQSSTSQTTKIIKEE
ZNF98	KEEKASQSSTSQTTKIIKEE
ZNF708	KGEKATLSSHSITKKVIKEE
ZNF85	KEEKAKQSSNSKTEKKIEEK
ZNF254	KEEKGNRSSNSTTKKIIKEK
ZNF273	KEEKANQSSTSTTKKIIKEE
ZNF730	KEEKANRSSTSHTTKRIKEE
ZNF429	KEEKANWSSTSNNSKKIKEE
ZNF680	KEEKDNQFSNSTTNKVIKDE
ZNF737	KEEKAKHPSVSHTTKRIKEE
ZNF90	KEEKAKLSSISASTKIIKEE
ZNF93	VEEKAKYSRISTSKEIIKEE
ZNF695	KEEKATWFSYSYTNKRIKEE
ZNF682	KKEKANHCSLSITEKRINEE
ZNF727	IEEKATYSSTSNIKKRIKEE
ZNF736	----------STFNKRIKEE
ZNF486	KEEKATRSSHSNTEKTTKKE
ZNF506	KEEKANRSSNSTTEKIIKEE
ZNF675	KKEKAKHSSASKTEKKIKEE
ZNF681	KEEKANQFSNSKTEKKITEE
ZNF141	KEEKANRSTTRVNEKKIKEE
ZNF718	SEENVTTSSDSTNVKRIKED
ZNF716	KEEKASLSSTSTTYKRTKEE
ZNF735	TEEKANCSSTSNTEKRVKEG
ZNF479	AEEQASLSSNSTTDKRIKEE
ZNF595	KEEKATRSTTSGIIRSIKEE
ZNF267	KKVKPTCFSNSGTVRRTTKE
ZNF519	KKEKANRGSHSHTQQRIKKE
ZNF415	KNEKVSQTSSSNTTQVIKNQ
ZNF616	KKEKVSDRSASHVGRRVKHE
ZNF610	KNEKVSLLSYLYTNQRIKNA
ZNF880	EKEKVRHKFCLSSNQRFRDE
ZNF480	KNEKVNQLSNLSTNQRIKNE
ZNF534	KNEKVSQNSNSHVRRNVSNE
ZNF766	KHEKVTQVSHSWVQQRS---
ZNF528	GSQKISQKSDSSTSHRIKNR
ZNF677	INEKAKQCSHSHWGQRTKTE
ZNF264	ELEKANHRSYKDIRFSIEVE
ZNF805	ELEKANHRSYADIRFSIEME
ZNF543	KMEKANRRSHADIRFSIEVE
ZNF460	KLEKANCRSHKDIRFNIELQ
ZNF550	KLEKAKRRSYAHIQYIIDMA
ZNF713	KNEKASQSAH----------
ZNF74	QGSKATCHSSAYLVRRIKNE
ZNF7	KDEKARWISRSHIQQRIVND
ZNF135	GNEKTSHSSSSSTKQRIENQ
ZNF527	KSEKTGYRSHLVIHKRSENK
ZNF2	EHQKASQKSISSTQQKIESE
ZNF570	ENVKASLRAYAYAQQRVEIE
ZNF184	ESEKASYLSNSSIQRKIKNE
ZNF71	VPERASQNMHSYIQQRFESE
ZNF181	ERIKAIHRSSSFVQQSIEQK
ZNF302	ERIKAIHSSSSFVQQSI---
ZNF140	IRKKASSGSESFIKQRIEDE
ZNF329	ESKKARDGSYAYIRQRIGNQ
ZNF19	ENEKSGRTSHEQKRLRIVDE
ZNF23	ENEKGRCSSQGKIQQRIENE
ZNF454	KNEKANQSTSSSARRKIRGL
ZNF283	EKEKANCGSSSSVKERVEKE
ZNF331	EKDKAICGSSSSVKERIKTE
ZNF780A	EKEKSNRSSNCQIESRIEQD
ZNF573	EKQKTTTGSKRNTRQNIEQE
ZNF30	EKEKAISRHQSYVQSRIEKE
ZNF345	----------SVVRQRIEKE
ZNF383	EKVKATKSSQSATNQRIDKE
ZNF566	EKEKASSGSNSDTRQRIEKI
ZNF565	EKEKARQHSQAQTRQRVEKD
ZNF582	AKEKTSHRSQSQKQQRIQKV
ZNF571	KKEKAISNSNAYTQEKIEKE
ZNF790	EKEKAIRGSNSYAQEKIEKE
ZNF529	--------SESATEQRIEKA
ZNF540	EKEKAMLRSVFYTEQRIKKE
ZNF619	----SSSNSVSRIVQRIEQE
ZNF621	----GSSNTASLIVQRIQKE
ZNF620	----ASSSSVTATQQRIEKE
ZNF274	RSEKIRNPRYSASQLRTKQD
ZNF485	KIEKTRKNSISTLEQKIQNE
ZNF354A	KSERASQSASSTIIERIKKV
ZNF354B	KSERASQSASSTIIERIKKV
ZNF879	ETQKATSISRSAIQQRIKNE
ZNF311	EEEKASGSSDAETKRRIREE
ZNF655	KKEKSSQSSSSYLEQRV---
ZNF200	SSQKNRQNSH------IKPE
ZNF597	KAKASRQHSHPGAQQKSQPD
ZNF28	EEEKVSRKSHSCTEQRVMNE
ZNF468	KEEKVSRKSHSHAQQRVKNE
ZNF808	KEEKVSQKSTSVAVTRIKNE
ZNF701	KNEKVNQQSNSHAQTVIKNE
ZNF816	KNEKTSQKSSSYAEQRVKNK
ZNF320	KNEKVKQRATSRAEQRVTNE
ZNF860	KNDKVSNATTSAVIKAIKNE
ZNF761	KNEKTSHKSSLTKRRRLKED
ZNF765	KNEKTSRKSHLTN----KEE
ZNF525	EEEKASFKSN------LKEE
ZNF611	KKVKAVWSSQSSETKIGKKV
ZNF75A	KSWKSSQNTN------TTHE
ZNF75D	RSWKSSHNTN------IKDE
ZNF483	TSNKSSHSSS------IKGE
ZNF445	QSDKDAYRSASNYRQRIWQE
ZNF789	EKVQARQRSASTIRQVIKLE
ZNF174	----------SEKRKRVTGE
ZNF202	FTIKSSQKSV----------
ZNF444	AWEKGGRREH----------
ZNF467	PTEKRRKKTHPNVASRAAAQ
ZNF425	SAERSRRRAHYRTEIRVQPE
ZNF786	QPERSRLKGQSKIEIRTQPK
ZNF213	GSDKSSLRSY----------
ZNF282	EAEKSNCHSG----------
ZNF398	SPQIDNGHSA----------
ZNF777	ISLKSSRPSH-------APE
ZNF496	VPNKIRWRVNSHLSRRIQCE
ZNF787	INEKSSHWSKSNMQQRITPD
ZNF212	----------SDVRQRISTE
ZNF236	RDYKGKKSSHSDVRVRIKDE
ZNF384	SNFKSRQLSHSNQSRRQKHN
ZNF324	APVKARHSSSSNSQRKIAAQ
ZNF324B	APVKARHSSSSNSQRKIAAQ
ZNF783	APYKARRPSD----------
ZNF316	PPDKRVYKSHAATRQWARPD
ZNF771	EPEKRSAASNSNAQLRVAPD
ZNF764	RLERATQRSASAYQRRVPPD
ZNF574	RGDKATQSSTYRLMRYHKRE
ZNF785	PPDRRRQRGSYLAIQRKSPD
ZNF628	RPLKTTHSSNSGRYLRDQGE
ZNF784	RTLRTNNSSN----------
ZNF148	QSQMRIQ---YLQREKIRDE
ZNF281	QSQMGIQ---YLQREKIGDQ
ZNF740	E-----------------DI
ZNF770	KVLKSRQSTHSKKRYLIGNI
ZNF296	ADQYAAQSSKSNTVRRSTEF
ZNF217	IMVFLPNK--ESIERKVESY
ZNF219	APVRCKEP--WFKNMKVDPF
ZNF513	ASLFAHYP--NHARMKTRAR
ZNF341	KVVCATFPKLRYRRLPTKQV
ZNF524	----------SDERSISQKV
ZNF581	----------SYQRSITEDI
ZNF580	----------LRQSRVSTGA
ZNF335	AEYFSRHKKNAEESKRAKPD
ZNF541	---KSCDYRSKGSSMCFPRE
ZNF385D	-EIVHNSETQ----------
ZNF711	QPHHKTNSSDNEKKMKTQEY
ZNF423	FNQMGLTESSESLQLTVVES
ZNF521	FPHMGLTDSSESLKVTIIES
ZNF280A	TQHRQPTPFQQVLQMKDVQV
ZSCAN10	RSGSADTRNSARRSQTSRNH
ZSCAN1	QAVTPPELHNTEGQSVAWMH
AC138696.1	ESIKKAQRHSTKQKGEACGN
ZSCAN16	KDSSKDEIQRIGHKKEDGRG
ZSCAN30	AKASECERGSIRREGEARSA
ZSCAN23	ISSTEDESQRFQQQSVAQNG
ZSCAN9	KDSTENESRSFNRHKEVQSG
ZSCAN31	RNSTEEESRRNERQKEAASG
ZSCAN22	EKASKGESRSTQQEDAAQSH
ZSCAN26	QNVSLIHRRSNRQEKETQAL
ZSCAN5	ADRTQNLMQLQFQTDVQQKY
ZSCAN5C	AERKQNLMQRQFQTDIQQKY
ZSCAN4	KEVKVPEFQIRVQTSMSHKN
FEZF2	TEVNVKVRQACRKKNQARST
ZFY	PMKKHTDNKKHNLEDEHHAA
HIVEP1	IEAAPVTKTKYKKIEERKPM
HIVEP3	IQPAPGPKTKYKRVEERKPM
IKZF5	KRAKRHLAYEEAMKELRDRN
IKZF4	KDVIHNQTQKLRIKPFARRA
SALL1	KRVGKNISTKKVFKKIATKN
PRDM5	NESKKKLAHRKNKQEELTPS
PLAGL1	KVAVQAHNRKKNLGEEKTMG
SP6	NHAA----KTKALVNW----
BNC1	----FTAYDKKIYKTINFSS
BNC2	----FNAYDKKIYRTINFSS
ZBTB1	RPELFNLYQRREYVQTQREQ
ZNF652	HFIEIGKSFTSRPNMKRRRT
ZBTB47	HYIEIGKSFTSRPNMKRRRT
ZBTB9	HHAPHGRRFRVHACFLRRDL
ZBTB39	HYRTVGHYSSTLNLMSKVGV
AC092835.1	HYKKDGKAFSQSSSLTKQKT
ZBTB5	-YALKGKRFSQSSHLYKSKT
ZFP2	HFENEGKAFSKNSSLTVQRT
ZFP37	HYENEGKAFSAKSQLVIQRS
ZNF691	HYRTVGKHFSRSSNLIRQKT
ZNF664	HYRCGGKAFSQSSSLCIQRV
ZNF697	HYTIEGKSFIQSSHLIRRRI
ZFP30	HYDKEGKAFRLHSSLIQQRI
PEG3	HYDHETETFTSSTAFSELKT
AC008770.3	HCESKNKAFRSYRSYLRKRS
PRMT3	--PLFNRLFTSAEETFSCKS
ZBTB40	HFPELGELFTSQAQLDSLES
ANKZF1	--FSTDQTFQNHQEQREYKL
ZBTB21	LFIHVNKAFRTNFRLWSFQS
PRDM10	HVCPHSKQYSSKTKMVQIRK
ZBTB38	HYAFQPKICKTAAALGMQKK
ZBTB4	HFTPHAKVCKTAAALSRGQR
REPIN1	HHQPEGKRFTNKPYLTSRRI
ZBTB10	HFSDIGKLFTRREHVKRSLV
ZBTB46	HYPEIGKKFTRREHMKRTLV
ZBTB8B	HYPETGKRFTRQEHLRSALS
ZBTB8A	HYPQAGKRFSRLDHLSSFRT
OVOL3	HFRSAGKAFTQRCSLEALAK
PRDM13	HYREFGKVLVRRRDLERVKS
PRDM2	HFKEFVQLFKDKTDLSERFL
SALL3	HFGTIGRAFTTKGNLKVMGT
ZBTB25	-MSTIGHKFPRKSQLLEMYT
ZBTB24	HFSPENLQFARLDNLKALKI
ZBTB34	HFREIGKCFPFQGTLNQLRK
TRERF1	HFPKEGKVFFKIKSRNAMKT
ZFP91	HFSNIGKKFEKKDSVVAKAK
ZFPM1	HFVLILSAFTTKANCERLKV
ZFPM2	HFRNHHFGFQTQRELLQQEL
FIZ1	HFPHIGKGFITLSNLSRLKL
CHAMP1	PYKTIGKAFLLESLLKNVAA
CPXCR1	KYFPIGRLFNTYSELRQS--
TSHZ1	HLKMYGHSFESLQDLSVMIK
TSHZ3	HLKMYGHSFESLQDLSVMIK
TSHZ2	HLKMFGDSFDSLQDLSVMIK
PRDM8	HLKPINESFRERHHLSRMTS
ZBTB41	HYKQINQSFRIKKTLTKLVI
ZFAT	HHLDMGKKFKQKPQLLRMEQ
EEA1	GFIPQMKSLGSADELFKYEA
RBSN	GFLPLLKDLQSFYQLHSYEE
SLC2A4RG	QCLKSGKVLSTASAMQRIRL
AEBP2	HFKVVGCNASSQGGLARVPT
ATMIN	HHKSKSNSYGTEWDLKRAEE
RLF	HCDNGGQIFTHRSNYSQVYY
CASZ1	HFHIRGCGFTSTSQMTSKRK
JAZF1	GHFCRGKSYKTAQGLRHTIN
ZNF462	FCYKSRRARIKHKMYFCEVH
ZMAT4	TLNMSTSAVVDSYQG---QH
ZNF346	PINMTSSPVVQSYLG---QH
ZKSCAN8	NVGKASYRSALSQDIYHKLI
ZNF397	NQGKASLRSYIIQRIYESLI
ZNF404	KEGKAGHRSSYQKKIYKELT
ZNF420	KEGKATQSSQILHRIYKELI
ZNF461	KEGKARQRSQTQQRLYEKFS
ZNF160	NESKVTQNSQANRRIYKNLA
ZNF347	HEGKVRRNSHARQLIYKNLT
ZNF251	DEGKTGLNSHRLRRIFGGLI
ZNF286A	SEKKTTESSSATQRIYENLT
ZNF286B	REKKTTESSSATQRIYENLT
ZNF391	NKGKSSRSTHIEQRTYENII
ZNF256	SEGKSIHSSSITQRVYMSLI
ZNF107	EEGKANQSSQTRK-IHKELI
ZNF138	EVGKAHQSSITKK-IYKALT
ZNF195	EEDSIKWFSDTKKRIYKDLS
ZNF117	EKVRANQASKTEKLIYEELT
ZNF43	EEGKASRSSNTKKKIYKELT
ZNF208	EEGKTSKVSTTTKAIYKKLM
ZNF253	EEGKAKQSSNTTKKIYKELT
ZNF275	EEGKRKKNAGSQLRVFDELA
ZNF112	EEDKGSRSSYQAQRVYKELQ
ZNF233	EVDKGSKASNQAQRIYKDLQ
ZNF227	EAGKGTRNTDHIFRVYKKLK
ZNF229	SEGKGCAKSAHKQHIYSGLH
ZNF239	EQGKGTRSSSLIQAVYKDLH
ZNF226	EEGKGICSSNYIQRVYKEYQ
ZNF234	EDGKCTCSSNRIQRVYKEYQ
ZNF155	EAGKAIHDSQKEKRIFKDFY
ZNF221	EEGKAIHDSQQEQRIFKDFC
ZNF230	EKGRAIHDFQQKQIIFKELH
ZNF14	KEGKAFYSASRAVIIYKKFR
ZNF20	KQGKVISFSSQYKMTYEKLQ
ZNF426	KEGKANYSNSQIGRTYVKLS
ZNF268	NNGKASFKSQIIQRIYEHLI
ZNF446	SDGRADWKSQVIRKG-----
ZNF358	PDGKSSHGATAQRGIYQALL
ZNF319	TLDKSSQSSHVHKRTYKALM
ZNF362	SYDKSRQLSHQQTRIYKP--
ZNF367	NINRVPREKSQAKRTYLD--
ZNF366	QVHKATQTSHKRMMQHNRLQ
ZNF438	HVNHHQFKQHRDMNTYSR--
ZNF408	PQDKAGTQRDKEQVVFADLR
ZNF428	TEEDSDNLGEHGFMLARE--
ZNF142	PVREERLSQAKELKSFHPKH
ZNF131	QYEKQDHFGHKELRKFEPST
ZNF414	LSTETPSMQEVASKLFKELF
ZNF451	PDNQVVDETSQNKQNGH---
ZNF407	VKTEPDSEQNFLIKGHVKAR
ZNF280C	FSSKVKNNIRMNMKHTTQLQ
ZNF280D	FSLKIKNNIRMNMKHTTQLQ
ZNF280B	LSVKVKN-VKMNVKHTTQLQ
ZNF207	HIHKKYTGPGAICMQ-----
ZNF292	QYRRHVSVTHNDLQMKCF--
ZNF395	-NGKVRSIVGKRVKAHLD--
ZNF318	TIGTMDFFTHHNKHTTLPGE
ST18	KPTCDGSGHVTGYASHSLSG
L3MBTL1	KPTCDGSGHVTGFTAHCLSG
MYT1	KPTCDGSGHITGYASHSLSG
KAT7	KPTCNSLGHLTGHERHSISG
L3MBTL3	GSTCKGIGHFKRHLGPSAAN
L3MBTL4	VPTCRGIGHIRGYSGHSAFG
ZNF385A	SNIIRFNSQS--QAEAYKGN
ZNF385B	SNVLRFNSDS--QAEAYKGS
ZMAT1	VHIIAFTSLD--MFRSMQGS
ZNF215	QVNKSFNRSSSLHQMIFKCK
ZKSCAN4	QNMKAFRRNSHLHQRIYKCN
ZNF165	GKERAFNLNSHLHQRIYECS
ZNF365	RPRDHTRFRSLSSLRALEFS
ZNF503	-DRATSE-------------
ZNF703	PDRATSE-------------
ZNF598	FDRLDNDHFDDAQDYYDYYL
ZNF469	RPVPEHGSSNTAKK------
ZNF510	EGTVQKSNEESWRKDHIQQK
ZNF717	EGTSHKSNEETINKLNGIKR
ZNF551	EGSTRKSSEGSSQSASIQQR
ZNF773	EGARHNSSEGFSHKSSINWR
ZNF772	IGVNHSSSEGYGHKYRIKWS
ZNF577	KGASRKCSDGTYFKSDTRQR
ZNF630	DGASQKSGEGTSQKSLIILR
ZNF585B	TGATQKSTEGAIRKSNITQR
ZNF568	EGAIQMSNQGASQRQNLEEK
ZNF569	EGAIQMSNEGASQKQNITQK
ZNF544	EGSRWNSNEGANRSTQIRLQ
ZNF606	EGARERSNKGSSQSCHVARR
ZNF624	EGSRIKSYDGSRTKSYIVQR
ZNF514	EGASQSS-----HTSSIKQR
ZNF559	EGAANSSQQGAIRSSFIRLR
ZNF470	ESTSQNAIEGASDGSYVQQR
ZNF471	EGARISSNEGASQTSNTQQR
ZNF583	VRASQIAKERTSQNAGAQQR
ZNF546	EGARFQTTEGTSRHYHTQHR
ZNF607	EGSRCASKEGTSHASHIIER
ZNF781	EGVICCSLERTRRSAHIRQR
ZNF599	EGATHHSKEAAYYSSSTRMR
ZNF517	RGRIRGSAEGAGRKSNTLQK
ZNF780B	EGFRRGSKEGASLHTQNHKN
ZNF623	EGSIRSSNEGAIRSSKIQQR
ZNF70	LGACHRSQKGASQSSSIEQR
ZNF493	EGANRSSEEGANRSSISIKK
ZNF724	EGANTSSKEGAKRSSNTERI
ZNF66	EGAKYSCEEGASRSSITTKI
ZNF726	EGAHRSSEESASRSSATTKR
ZNF676	EGANSSSEEGATWSSSTKKR
ZNF728	EGATTFSEEGAKWSSNMEKR
ZNF729	EVANSFSEEGAKHFSARKKV
ZNF678	EGTNRCSKEGANKFSSTQRR
ZNF679	EGANCSSEEDAKWSSSANKS
ZNF732	EGASRFTEEGAGWSAYSKKK
ZNF721	EGAGRYTEEGASRSRNTTRR
ZNF578	DGAIHQSNEHTSHRSSPCRR
ZNF600	VDAACHSNESTSQRSYHCRR
ZNF665	EVVTQYSNDGVTQNSHASRG
ZNF473	EGTSHSANEGTRQSSCSKQR
ZNF48	EGGADSSPEGGRRSSDVKHR
ZNF500	EGRSQSSPAGGRRGTDHKQR
ZNF572	EESGCNSCEGSGLSSHIRQR
ZNF629	VGTTLSAADGSIMSSTIRQR
ZNF497	DGAVRVAAEGAVMGSYAERR
ZNF696	DGASRSSTEGARLSFHIQRR
ZNF491	QGATCSTKQGARSAKYRIGR
ZNF700	QGARCCNKQGARSASHRMER
ZNF625	QGASHSGSEGAHSSTCHAKI
ZNF709	QGASCSSKQGASCSSSRMER
ZNF763	QVSSYSAQQGAHSSSSQAKR
ZNF788	QGARSASKQGVRYWSGRIGL
ZNF699	EGTSRSSKEGAISSSHTVIR
ZNF670	EGASRSTIKGARCSRVRVER
ZNF705A	LEATNCFHLGATQCSHRREK
ZNF705D	LEATNCFHLGATQCSHRREK
ZNF705B	LEATNCFHLGATQCSHRREK
ZNF556	HGARCQKKQGACWATSQRVR
ZNF57	HGATSSRKQGATWSSTREVR
ZNF618	-------GIGKKYYNCQTVR
ZNF80	EGVNRRSSEGTSYHSVIQRV
ZNF560	KGATERSNAEASRSCVTQLK
ZNF646	EGARLRKPTPTSNRMAKDQR
ZNF775	EARSQKQNEGSTWWSSNIQR
ZNF672	EGGLESAATGGGQRSDVVQR
ZNF689	ENRRQRTEHERSQRSTLQQL
ZNF648	ADEAVASADGAAQPSRVRQR
ZNF668	RGMSDPSLQDTVASWDKRAL
ZNF526	DGGGTELGVGGKKLIHRNLR
ZNF683	-------NIGSGQLSNKVLR
ZNF710	EDSHYRSEVGETLQANKRML
ZNF516	FKQERKKEVGASQTWFKAMK
ZNF536	FKKKKREEVGVSQAWFKGMR
ZNF488	-------PVQHRERHHSRMT
ZNF507	QESHYKSDVDTTTYVGRNRR
ZNF511	-------SFKAPSGHLDAIL
ZNF645	-------QQKTLSQKSQAIK
ZNF532	DSLAQKQRQDSSSSHSCRNR
ZNF687	SPLAQKRRLESCSAPSRRVR
ZNF592	EQWPDRERQESHTPNSRKIR
ZNF512B	-------EGGASSLMGQYQR
ZNF608	-------PNNKKHINGRYQA
ZNF609	-------PNNKKHINGKYQA
ZNF654	-------LGVIKRIGFNKAM
ZNF518A	INEVY--EKKSQDVGTVQIH
ZNF518B	-------DKRSKDPLQKKTL
ZNF639	VKSSTNMEQDQSSSSEYLFQ
ZNF746	RGCTRHRMLERTESKITSIR
ZNF587B	EGSSQSQQFEYSLGYRESSS
ZNF688	VTRTYLSRMERKRFAE----
ZNF575	PPASYKALTHSGHSKAPSCY
ZNF747	HAGGHSKAIEAMRTATRCGL
ZNF579	APARRSRLVDARLSYRWGRR
ZNF644	---------KNREKHHATRD
ZNF576	IFSPSATRSDTGQVSRADAQ
ZNF804A	--YELQYKHQEDNIN-D---
ZNF804B	--YELQHKHQEDNIN-D---
ZNF800	EVYKLQTSKQNTKIELERRK
ZNF829	RIEKEATQHSRIQQREAGSR
ZNF850	RIDKESASGSALQQRESTSR
ZNF837	RVAPEANQRSNSRQRDASQR
ZNF835	RTPHDRSNRSHLQRLGASFS
ZSCAN18	---------------GTHFS
ZNF813	RLKNEVNKKANARHRETSRI
ZNF845	AIKNEASQKSSTCLRETRHN
ZNF888	TIKNEVNQQSNARHRESNHK
ZNF836	RIKNVVNDSGNSNKREVNST
ZNF841	RMKNVVIDSGNSIRREVNST
ZNF83	RIKNEVSHKSSVNWREVSQN
ZNF852	RTKNEASRSKCIRQSEAGLS
ZNF91	IIKEEANRSSNTIKFEAKHS
ZNF92	IIKDEANQSSTTKKREANQS
ZNF99	VIKEEANHFSARKKIEANNS
ZSCAN12	GVENEAVYNSSVSQEEARGI
ZSCAN21	RLKKEANHSSNNKHRHTCSK
ZNF853	RIASYRSESSAVQQR-RRHK
ZSCAN25	RTVSETSQRHHEVQRASNQR
ZSCAN32	RTQGQSNQSSSIVQRHGTKN
ZSCAN2	RIKTDRSQSSAITRRECSQR
ZNF814	RVQGESSQKGNVLQRESSHK
ZSCAN5B	RIKKYVSHKGNNVQRTARQL
ZNF843	---------------AGTQS
ZNF865	QVASDHPDLFHMSKEVGLRS
ZNF844	TADKETISHSSQRMIKAKCP
ZNF878	RKEKLGISSTSRYEKQVRVA
ZNF831	--LPHDLKPSVEKIRTAKTQ
ZXDA	RSQAFTITVSAFSNRGSTRA
ZXDB	RSQAFTITVSAFSNRGSTRA
ZXDC	RSKDFTITVSAFSNRGSTRA
ZEB1	RIEPNRSHSGSSSISIAKHK
ZEB2	RIEPNRSHSGSSSISIAKHK
ZNF830	LGSAL--TPVKELWQVQREK
HNF4A	ARKSRKHMSRFSQVDDKQYK
HNF4G	ARKSRKHVSRFSQVDDKQYR
NR2E1	KRKYRRRTVKSGGPDTHQAK
NR2E3	------------MPDAHQAK
NR2C1	VKRVRKLVSRGSDINHHRYQ
NR2C2	VKRVRKLTSRSNDINHHRFK
NR2F1	VKKFRRLTTRANNPDHHQYK
NR2F2	VKKFRRLSTRANNPDHHQYK
NR2F6	VKKFRRLSTRSNDQDHHQYK
NR4A2	ANQRQKAKVLANNPDRRRYQ
NR4A3	ANQRQKAKVLANNPDRRRYQ
NR4A1	ANQRQKAKILANDPDRRRFQ
RXRA	ARKYRKLTTRDNDLDRQRYQ
RXRG	ARKYRKLITRDNDLDRQRYQ
RXRB	ARKYRKLTSRDNDTDRQRYQ
RARA	FKYSQKMVTHRDNINVTRYQ
RARB	FKYSQKMITHRDNVNVTRYQ
RARG	FKYSQKMVTHRDNINVTRYQ
RORA	KKIIQSATSPRQNLDTSRHQ
RORB	KKIIQNASSPRQNLDTNRHQ
RORC	KKIIRCAASTRQNPDTSRHQ
NR6A1	LRLICNRVRSRDNVSKQRYL
NR1D1	KVFHQQIQKCLKNSVINRQK
NR1D2	KVFHQQIQKCLKNSMMNRQK
PPARA	RKYHRLLVDCDR-KQKNKYH
PPARD	RKFHRMLEECER-KQKNKYQ
PPARG	RKFHRLLIDCDL-RHKSKYQ
NR3C1	LECLEGHNLAGRDIDIRNAR
NR3C2	LECVEGHNLAGRDIDIRNAQ
PGR	LECLEGHNLAGRDIDIRNAR
AR	LECLEGQKLASRDTDFRNSR
ESR1	AYYWQGNDMPATQTDNRSAR
ESR2	AYYWQGNDIPATQTDNRSAR
ESRRB	LIYAQGIESPATEETRRSAM
ESRRG	LIYAQGIESPATEETRRSAM
ESRRA	LVYAQGIESPASEETRRAAT
NR5A1	PKYLQNKHTTESSKDTQRFQ
NR5A2	PKYLQNKRTIENNQDTQRYQ
NR1H3	SKFLIKAHIHSGHPDYMKER
NR1H2	RKFLVRRRARGGTQDFMKQR
NR1H4	VRYLTKAVKKNGNVDYMKER
NR1I2	RKYMKRARRPFRAETKTQAR
VDR	GRFMKRALTPFNDRTDNHAK
NR1I3	VQYLSKIGTPFASESTQHAQ
THRA	VKYIQKPTSKYDCVDITQLK
THRB	VKYIQKPSSKYEKVDVTQEK
GATA2	VTLGKMNCNQTTLRNNGVAY
GATA3	VTLGKMNCNQTTLRNNGVAY
GATA1	VTLRKMNCNQTTLRNSGVAY
GATA4	VMLGKMNCNQTTLRNEGVAY
GATA5	VLLGKMNCNHTTLRNEGVAY
GATA6	VILGKMSCNHTTLRNEGVAY
TRPS1	-------CNLTTLRNNGVAY
ZGLP1	-------CSRTQLRADGLAR
GATAD2A	-------CQKTDRRESGMNT
GATAD2B	-------CQRTDHKENGLQS
FOXC1	IATQNDQMDRDKQVDDGTDS
FOXC2	IATQNEQMDREKQVDDGTDS
FOXS1	IAAQSGRMGRHRPVDDGTDC
FOXL1	IAAQDEQMDRDRQVEKGTRC
FOXI2	SAAQSLQAGNRKAKDEGTNC
FOXI3	SAAQSEQADSRKAKDEGTNC
FOXI1	SAAHGDQADNKKAKDEGTNC
FOXL2	VAAREEQIAKKKKIEGRTAC
FOXD1	IATLQKESGREFPVEPGTES
FOXD2	IATLQKESGREFPVEPGTES
FOXD3	IATLQQESNREFPVEPGTQS
FOXD4L4	IATLQHASGRRFPVEPGSAS
FOXD4L3	IATLQHASGRRFPVEPGSAS
FOXD4L5	IATLQHASGRRFPVEPGSAS
FOXD4L6	IATLQHASGRRFPVEPGSAS
FOXD4L1	IATLQHASGRRFPVEPGSAS
FOXD4	IATLQHASDRRFPVEPGSAS
FOXE1	IAAAHEKTERDPKLEAGANA
FOXE3	IAAAHGRTERDPRVEPGTAA
FOXG1	NAMRQEEMKNEKQVHYGMSS
FOXA1	ISTQQSQMDLQQQVSPGTDS
FOXA3	ISTQQGQMDLEQQVSPGASS
FOXA2	ISTQQNQMDLQQQLSPGTDS
FOXB1	ISAQSEKMDRETQIRPGASC
FOXB2	ISAQHEKMERETQIRPGADC
FOXK1	AQVSSDATKHTDKISQGRAS
FOXK2	AQVTMDTTKNTDKISQGRAS
FOXJ1	ATCQAAKTDNHDPIEKGRQY
FOXJ2	ATTNSARCDNNGIRPRGTCP
FOXJ3	ASTNSKQCDNEGSLSKGANP
FOXF1	IAVQSTQQSRGYQIGLGTAS
FOXF2	IAVQSSQQARGYQIGLGTAS
FOXQ1	IAARDGEMGKGYTVDPWMNS
FOXH1	LAAQASRQAVEYERDPQASL
FOXN1	SIFKNTNTEHTPDEKSSAAK
FOXN4	SCAKNTSKEHTPDEKMSAAR
FOXN2	SLYEHNSLDHTPTQSHNCEY
FOXN3	SCFEDTNLEHNPTKERICEY
FOXM1	MAQNSRTEDHHAKVANSTSA
FOXO1	ADTESEEVKSDSSIEGTMEG
FOXO6	ADTESDDVRYDSSIEGTMEG
FOXO3	ADTESDEVRCDSSMEGTIDG
FOXO4	PDEESEEVRTDSSIEATMEG
FOXP1	ASRLEENTRM-NAVV--TVE
FOXP4	ASRLEDNTRM-NTVV--TRE
FOXP2	ATRMEDSTRT-NAVV--TVE
FOXP3	ATRLEEHTRM-HPVE--TLE
FOXR1	FHARNPSRKHTAPESMAKEG
FOXR2	SHARNHNRQHTAPESLDKEG
ZC3H8	ICFKCGKEMCGYCFTKGKA-
MBNL2	CRQCSDNIACGENRCRPYRC
CXXC1	QIAEERRTHDFRKKPNKIKL
MBD1	TNNAALRRRDFCPKSNQKKW
KMT2A	KKSQPQVPVTNLPKRNIKCM
KMT2B	GKMHRLRVSVNLPKPNTKCY
KDM2B	GARKELRTEHFKKKPGRMSM
FBXL19	GARRRVRTDHFRKKPGRMSL
KDM2A	GARKKVQGVHYRKKPGRMSL
DNMT1	ENRVEQQPKKAKVKSGRSAE
CXXC5	SGRMARRRQSSR--RKTGIF
CXXC4	PARVVKRLVSSR--RKTGIF
TET1	LERVEQQKETYK--RKNSIK
TET3	DGRTERRLATST--RRT-IL
JRKL	RKLKDKKL-SSQVIGETTDK
TIGD2	RKLKDKKL-SFKVVGESTDK
JRK	RKLKDTRL-SRAQEGMSTDA
TIGD7	GKLKKSRI-SLSDESKSTDK
TIGD6	KKFKKGAV-RKDKETPSTTK
TIGD4	KKLKDNAV-KKEAEKKNSSK
CENPB	PKLKRQEVDRKERRPPSTTK
DMRTA1	-RCNGSALRCRRACTLIAQM
DMRTA2	-RCNGSALRCRKLCTLIAQM
DMRT2	-RCNGSCLRCRRQCLLVVQM
DMRT1	-RCNGSPLRCMRQCNLIAQM
DMRT3	-RCNGSWLRCRKTCILIIQM
DMRTC2	-RCNGAHLRCLQECVLILRM
DMRTB1	-RCNGVPVGCRKLCYLISQM
TIGD1	KSLKEKLSS-KERRLRQTQN
CENPBD1	REIKERRFK-LQKAAISTTD
TIGD3	KKLKQELL-SQERRSQPQRK
TIGD5	--YKQERV-RQSRDPGGTGK
