ARID3A	EFLDDLFSFMQKPIMAKINK
BHLHE40	KLPHRLIEKKRRNECIAVVL
MAX	AHHALRDHIKDSSLQGEKLY
MYC	RTHVLRNELKRSELENNEKA
TAL1	IFTSRQQNVNGATHPPDKKL
USF1	ASKIIPDCSMESTKSGQSQR
USF2	ASKIIPDCNADNSKTGASRR
TCF12	MGRMCQLHLK--SEKPQTLE
ATF1	DPQLKREIRLMKYVKCLENR
ATF3	EEDERKKRRRERKTECLQKL
FOS	KIMTQALQTANLKEKEKFI-
FOSL1	RVLFKGLQREEQKQKERLVE
BACH1	SCQNSIKQSKESKEDHILST
NFE2	GTVQRLRTNRERRAGEADRT
JUN	MRAREVTKANSESTNMLREM
JUND	LRSREVTKSNTESTSLLREL
MAFF	VCKKSERAAGCRLKQRRRGY
MAFK	ITRRVQQSSSYRLKQRRRGY
CEBPB	DMHVLTAEQNFSDEYKINIA
MEF2A  RMDENVTFLCDCEIFSSKQY
SRF    FDNKRTSTITGTQVAETHTF
NRF1   SPSIKQLLAQQAISPKPPKV
E2F1	DVVWAEVKQIVEQIASHQL-
E2F6	GILKVTKGRVVDDVESHRI-
SPI1	-VKKKTQS-LD-LRSMSWVK
GABP	-ICQRVKV-LE-LTDACSVD
STAT1	RVKLKLYNKLKDVNEGTTVM
STAT2	TSRTRGESTSRNPPQTSQTL
STAT5A	KTTVGHNPQTSEQQASLNCV
CTCF	QELSYCPRNLDSKGRALHPD
CTCFL	HDVMFSSMSFNTLLKTVYNN
EGR1	YAVESCDRRFSRSDELTHII
ZNF263	HL--LCGKNFSNNSNLIHQI
ZBTB7A	QK--ICEKVIQGAGKLPHIT
SP1	IQGVYGHLWMTSYKAPEPSI
SP2	VPDTFRLVLVNFFAEAQQTY
SP4	IEGVYGHLWINMFREPESSV
ZBTB33	YISCLSPREVPLEYTENYQF
ZNF143	QEATGGRSTSKTGDQITSNI
YY1	APMDNAVAGAVESKKQLDFN
REST	HKTSEHTGNFDRNNVVQKTH
NR2C2	EYVVAVGNTSSQDIKHFKEM
NR2F2	IEVVQFSNSTARNPQHYKKV
RXRA	HIAIVYGDTTDKDLKRYQAM
SIX5	-YFK--RRALLLTV-WR---
POU5F1	ALKERIALGVQTIRALMRQK
NFYA	EPLYVNAKQYHRILKRRQAR
BRCA1	SLQESTRFSQLVEELLKIIC
GATA1	RDRTGHYLTNCQSGDLHQHY
GATA2	RDGTGHYLANCQNGDLHNVN
ELF1	YAQAPKYQSKDAELQQRGIL
ELK1	TQRGGHISAENRSFKQLLRE
ETS1	QETSQSFGPDKHAYRDKNII
IRF1	IPLPWWICITGTADVKQSGS
THAP1	SCAYDHFSAVRKHFCNKLNA
TBP	AAIFSGKLMGSQLYKPIVFV
NFYB	GGHMNSEIVRIEETSECHRK
RFX5	MYYLEPQASACNIAGGGQCY